111111111111111111111111
100000000000000000000001
100N00000000000000000001
100000000000000000000001
100000111110000101010001
100000100010000000000001
100000100010001100000001
100000100010000000000001
100000110110000101010001
100000000000000000000001
100000000000000000000001
100000000000000000000001
100000000000000000000001
100000000000000000000001
100000000000000000000001
100000000000000000000001
100111111000000000000001
100100001000000100001001
100000101000000000000001
100100001000000000000001
100111111000000100001001
100000000000000111111001
100000000000000000000001
111111111111111111111111