NO ./path_to_the_north_texture
SO ./path_to_the_south_texture
WE ./path_to_the_west_texture
EA ./path_to_the_east_texture
F 220,100,0
C 225,30,0
222222221111111111111111111111111
222222221000000000110000000000001
222222221011000001110000000000001
222222221001000000000000000000001
111111111011000001110000000000001
100000000011000001110111111111111
111101111111110111000000100012222
111101111111110111010100100012222
110000001101010111000000100012222
100000000000000011000000100012222
100000000000000011010100100012222
110000011101010111110111103011122
111101112111010121011110100012222