NO ./assets/siding0.xpm
SO ./assets/siding1.xpm
WE ./assets/siding2.xpm
EA ./assets/siding3.xpm

C 216,166,212
F 178,134,34



11111111111111111111111111111111111111111111111111111111111111111111111111111111
10100000000000000000000000000000000000000000000000000000000000000000000000000001
10001111111111111100111111111111111111001111111111111111101011111111111111111101
11011000100011111110000000001000000001000000001110000000100000000000000000000001
11011010101011000011111111001000110000111111000000011100010000000001111100000111
11010010001000010001000000000000100110100001111111111100111111000111111111111111
1101011111110011110111111111111111111010110001111000000010001101111     11111111
1000000000010000010000000000000000001000011000000011110000100111           11111
10111111111111100111100011111001111111111111111111111111111111               111
10010001000001100111111111111111111111    1111111111111111111   1  1   111    1111111111111111111111111111111111111111111111111111
1001110101110110011111111111111111            11111111111111   1   1  1   1    100000000000000000000000000000000000000000000000011
1000010101110110011111111111111                  11111111111  111111    11      1000000000000000000000000000000000000000000000S011
101001010001011001111111111                          1111111       1   1       100000000000000000000000000000000000000000000000011
101000011101011001111111                                11111     111 11111   1111111111111111111001111111111111111111111111100011
10111111110100100111                   1                    11               11111111111111111111001111100000000000000000000000011
101    1110100100111                 11111                    111         11111111100000000000000001111100000000000000000000000011
101    1110111100111                1110111                      111   11111111111100000000000000001111100000000000000000000000011
101    111011 100111              11110001111                       11111111111111100000000000000001111100000000000000000000000011
10111111110111101111           11111000000011111                      111111111111100011111111111001111100000000000000000000000011
1011111110001100110011           11000000000011                         1111111111100011111111111101111100000000000000000000000011
10000000000110010001111           10000000001                             11111111100011111111111101111100000000000000000000000011
10111111001000100100001            100000001                             111111111101111111111111101111100000000000000000000000011
1011111110010000100001              1100011                             1111111111100111111111111001111100000000000000000000000011
101001100100111000101                 111                              11111111111100000000000000001111100000000000000000000000011
10000110010001111111                   1                              111111111111100000000000000001111100000000000000000000000011
11100110010011                                                       1111000001111100111111111111001111100000000000000000000000011
1010011001001                                                       11111000001111101111111111111101111100000000000000000000000011
10100000011011                                                     111111000001111100011111111100001111100000000000000000000000011
101000001110111                                                   1111111000001111100111111110000001111100000000000000000000000011
1011110010101111    11111111111                                  11111111000001111100001111100011001111100000000000000000000000011
10001100101011111   10000000001                                 111111111000001111101001110000111001111100000000000000000000000011
100000001010111111  10011111111                                1100000011000001111101100100011111001111100000000000000000000000011
10101111101010000111100111                                    10000000011000001111101100000111111001111100000000000000000000000011
1010101000101010001100000111111                              111111100011000001111101111111111111101111100000000000000000000000011
1010101010111010000111100000001111                          1111111100011000001111101111111111111101111100000000000000000000000011
1010001010101011000011111000000001                         11111111000011000001111100000000000000001111100000000000000000000000011
1000011010101011000001111000000001                        110000000000011000001111101111111111111101111100000000000000000000000011
1100110010101011100000111111111111                       1110000000000011000001111101110011111100101111100000000000000000000000011
1001100010101011110000011                               11000001111000011000001111100110011000100101111100000000000000000000000011
10110011111010111110000011                             111000001111000011000001111101011111010111101111100000000000000000000000011
101001100010101000110000011                           1110000011111000011000001111101100000111000001111100000000000000000000000011
1010111010101010001110000011                         11100000011000000111000001111101111111111111101111100000000000000000000000011
10101010101010100000110000011                       111000000011000011111000001111101111111111111101111100000000000000000000000011
101010101010101000000110000011                     1111000000011001110000000001111101000000000000001111100000000000000000000000011
1010101010101010110001110000011                   11111000000011100111000000001111100111111111111101111100000000000000000000000011
1010101010101010110001111000001111111111111111111111111111110001100011100000001111100111100000111101111100000000000000000000000011
1010101010101010110000111100000110000000000000000000000000011100000000111000001111100111111111111101111100000000000000000000000011
1010101010101010110000001110000011000000000000000000000000000111000000011110001111101000000000000001111100000000000000000000000011
1010101010101010110000000111000001100000100000000000000000000001110000000110001111101111111111111101111100000000000000000000000011
1010101010101010110000100011100000110000000001111111111000000000011100000110001111100000000000111101111100000000000000000000000011
1010101010101010110000110001110000011000000011111111111000000000001110000110001111100011001110000101111100000000000000000000000011
1010101010101010110110111000111000001100000111111111111000000000011100000110001111101111101101110001111100000000000000000000000011
1010101010101010110000111100011100000110001111111111111000000000111000001100001111101111101100111101111100000000000000000000000011
1010101010101010110000111110001110000011011111111111111000000001110000011000001111101111101101110001111100000000000000000000000011
1010101010101010111001111111000011000011011111111000001100000011100000110000001111100011001110000111111100000000000000000000000011
1010101010101010110000111111001001110000000001111000011000000111000001100000001111100000000000111111111100000000000000000000000011
1010101010101010110000111110011001111000000011111000011000001110000011000000001111111111111111111111111100000000000000000000000011
1010101010101010110000111100111100111100000111111000011000011100000110000000001111111111111111111111111100000000000000000000000011
1010101010101010110000111001101110011110001111111000011000000000001100000000001100000000000000000000000000000000000000000000000011
1010101010100010110000110011001111001111011111111000011100000000011000000000001100000000000000000000000001110000000000000000000011
1010101010101010110001100110011001100111011111111000111110000000110000000000001100000000000000000000000000111100000000000000000011
1000101010101010110001001100111001110011011111111000111111000111100000000000001100000000000000000000000000001110000000000000000011
1001101010001110110011001001111001111001110000000000111111111100000000000000001100000000000000000000000000000000000000000000000011
