11111111111111
10000000000001
1000000E000001
10101010101011
11111111111111
