11111111111111
10000000000001
11111111111111
10101010101011
11111111111111
